~~~~  ----  ~~~~
~~~  ------  ~~~
~~ ----  ---- ~~
~ ----    ---- ~
 ----      ----
----        ----